1111111111111111111111111111111111
1100000011C0000000011C110011000001
1000110001000111000010000010000101
11C11110000011100000000000000111E1
1000110000011100000111100000111111
10000000100000000011111001000111C1
1C1100C1110000P00111C00011C1000001
1111111111111111111111111111111111
