111111111
1PE0CA001
111111111
