111111111
100000000
111111111
